={
{ 2 , 2 , 2 , 2 , 2 , 2 , 2 , 2 , 2 , 0},
{ 2 , 1 , 1 , 1 , 2 , 1 , 1 , 1 , 2 , 0},
{ 2 , 1 , 2 , 1 , 2 , 1 , 2 , 1 , 2 , 0},
{ 2 , 1 , 1 , 7 , 4 , 7 , 1 , 1 , 2 , 0},
{ 2 , 2 , 2 , 3 , 5 , 3 , 2 , 2 , 2 , 0},
{ 2 , 1 , 1 , 7 , 4 , 7 , 1 , 1 , 2 , 0},
{ 2 , 1 , 2 , 1 , 2 , 1 , 2 , 1 , 2 , 0},
{ 2 , 1 , 1 , 1 , 1 , 1 , 1 , 1 , 2 , 0},
{ 2 , 2 , 2 , 2 , 2 , 2 , 2 , 2 , 2 , 0},
{ 0 , 0 , 0 , 0 , 0 , 0 , 0 , 0 , 0 , 0}
}