
 0  0  0  0  0  0  0  0  0  0
 0  2  2  2  2  2  2  2  2  0
 0  2  1  3  1  1  3  1  2  0
 0  2  3  4  4  4  4  3  2  0
 0  2  1  4  3  3  4  1  2  0
 0  2  1  4  3  6  4  1  2  0
 0  2  3  4  4  4  4  3  2  0
 0  2  1  3  1  1  3  1  2  0
 0  2  2  2  2  2  2  2  2  0
 0  0  0  0  0  0  0  0  0  0
