
 0  0  2  2  2  2  0  0  0  0
 0  0  2  1  1  2  2  2  2  2
 0  2  2  1  1  1  1  1  1  2
 0  2  1  3  7  7  4  1  1  2
 2  2  1  2  1  1  2  5  2  2
 2  1  1  4  7  7  3  1  2  0
 2  1  1  1  1  1  1  2  2  0
 2  2  2  2  2  1  1  2  0  0
 0  0  0  0  2  2  2  2  0  0
 0  0  0  0  0  0  0  0  0  0
