
 2  2  2  2  2  2  2  2  2  0
 2  1  1  1  3  1  1  1  2  0
 2  1  2  4  2  4  2  1  2  0
 2  1  4  3  1  3  4  1  2  0
 2  3  2  1  1  1  2  3  2  0
 2  1  4  3  1  3  4  1  2  0
 2  1  2  4  2  4  2  1  2  0
 2  1  1  1  6  1  1  1  2  0
 2  2  2  2  2  2  2  2  2  0
 0  0  0  0  0  0  0  0  0  0)
