
 0  2  2  2  2  2  2  2  0  0
 0  2  1  1  2  1  1  2  0  0
 0  2  5  1  4  1  1  2  0  0
 0  2  1  1  7  3  1  2  0  0
 0  2  2  7  1  7  2  2  0  0
 0  2  1  3  7  1  1  2  0  0
 0  2  1  1  4  1  1  2  0  0
 0  2  1  1  2  1  1  2  0  0
 0  2  2  2  2  2  2  2  0  0
 0  0  0  0  0  0  0  0  0  0
